NO ./textures/CookieMonster.png
SO ./textures/elmoonfire.png
EA ./textures/grover.png
WE ./textures/Pino.png

F 0,128,0
C 0,60,119

1111111111111111111111111
1000000000110000000000001
1011000001110000000000001
100100000000000000000000111111111
111111111011000001110000000000001
100000000011000001110111111111111
11110111111111011100000010001
111101   11111011101010010001
11000111110101011100000010001
10000000000000001100000010001
100000000N0000001101010010001
1100000111010101111101111000111
11110111 1110101 101111010001
11111111 1111111 111111111111
