NO ./textures/elmoonfire.png
SO ./textures/Pino.png
EA ./textures/CookieMonster.png
WE ./textures/grover.png

F 0,180,0
C 255,60,0

1111111
1000001
1000N01
1000001
1000001
100000111111111111111111111111
100000000000000000000000000001
100000000000000000000000000001
100000111111000000000000000001
1000001    1111111000010001101
1000001          1111110001101
1111111             1110001101
                    1111111111