NO ./textures/elmoonfire.png
SO ./textures/Pino.png
EA ./textures/CookieMonster.png
WE ./textures/grover.png

F 0,180,0
C 255,60,0

111111111111111111111111
100000000000000000000001
100000110011000000000001
100000110011000000N00001
100000110011000000000001
100000000000000000000001
111111111111111111111111