NO ./textures/elmoonfire.png
SO ./textures/CookieMonster_cropped.png
EA ./textures/l-intro-1690905734.png
WE ./textures/Pino-670x375.png

F 0,180,0
C 255,60,0

111111111111111111111111
111111110000000000000001
100000000011000000000001
100000111011000000N00001
1000001 1011000000000001
100000111000000000000001
111111111111111111111111